00000000000
00000000000
00000000000
00000000000
11111111111
22222222222
33333333333
44444444444
55555555555
66666666666
00000000000
00000000000
00000000000
00000000000
00000000000
00000000000
00000000000
00000000000
00000000000
00000000000
00000000000
00000000000
00000000000
00000000000
00000000000
00000000000
00000000000
00000000000
00000000000
00000000000
