00000000000
00000000000
00000000000
00000000000
99999999999
55555555555
66666666666
88888888888
77777777777
44444444444
00000000000
00000000000
00000000000
00000000000
00000000000
00000000000
00000000000
00000000000
00000000000
00000000000
00000000000
00000000000
00000000000
00000000000
00000000000
00000000000
00000000000
00000000000
00000000000
00000000000
