00000000000
00000000000
00080008000
00008080000
00008080000
00011111000
00011111000
00112121100
00112121100
01111111110
01111111110
01011111010
01010001010
01010001010
00001010000
00001010000
00000000000
00000000000
00000000000
00000000000
00000000000
00000000000
00000000000
00000000000
00000000000
00000000000
00000000000
00000000000
00000000000
00000000000
