00000000000
00000000000
00000000000
66666666666
00000000000
777AAAAAAAA
00000000000
22222222222
00000000000
AAAAAAAA222
00000000000
55555555555
00000000000
555AAAAAAAA
00000000000
44444444444
00000000000
AAAAAAAA444
00000000000
00000000000
00000000000
00000000000
00000000000
00000000000
00000000000
00000000000
00000000000
00000000000
00000000000
00000000000
