00000000000
00000000000
20000000000
23000000000
23400000000
23450000000
23456000000
23456200000
23456230000
23456234000
23456234500
23456234560
11111111115
00000000000
00000000000
00000000000
00000000000
00000000000
00000000000
00000000000
00000000000
00000000000
00000000000
00000000000
00000000000
00000000000
00000000000
00000000000
00000000000
00000000000
